2 2 2 5 0 5 5 2 2 0 0 0 0 0 0 0
30 0 2 2 0 0 2 23 23 0 0 0 12 12 26 2
4 4 5 30 30 2 14 0 0 30 4 5 13 7 0 2
30 0 9 26 25 1 1 26 25 10 10 0 12 7 7 2
30 30 0 7 7 7 23 29 10 10 10 0 0 26 0 1
30 1 9 0 5 0 26 10 10 9 10 13 0 1 1 1
41 56 57 49 40 47 32 61 0 9 10 10 0 14 1 0
9 7 2 23 0 10 10 58 7 26 7 29 9 9 4 5
9 9 2 29 9 9 10 55 0 0 9 9 9 0 1 7
0 7 0 0 9 1 4 61 10 10 10 0 0 29 1 14
0 5 7 0 7 30 7 49 9 2 2 2 0 1 2 14
0 5 0 0 0 0 30 57 29 7 7 2 2 2 0 0